111111
100101
10B001
1100N1
111111