NO tests/textures/N.xpm
SO tests/textures/S.xpm
WE tests/textures/W.xpm
EA tests/textures/E.xpm

C 128, 128, 128
F 200, 200, 200

1111
1001
1N01
1111
